#Version
1.8.0.0

#Music Category
7

#Width
21

#Height
15

#Sprite Water Layer
0,0,0,0,0,0,0,0,0,0,0,0,0,0,0,0,0,0,0,0,0
0,0,0,0,0,0,0,0,0,0,0,0,0,0,0,0,0,0,0,0,0
0,0,0,0,0,0,0,0,0,0,0,0,0,0,0,0,0,0,0,0,5
0,0,0,0,0,0,0,0,0,0,0,0,0,0,0,0,0,0,0,0,5
0,0,0,0,0,0,0,0,0,0,0,0,0,0,0,0,0,0,0,5,5
0,0,0,0,0,0,0,0,0,0,0,0,0,0,0,0,0,5,5,5,5
0,0,0,0,0,0,5,5,5,0,0,0,0,0,0,0,0,5,5,5,5
0,0,0,0,0,0,0,0,0,0,0,0,5,5,5,5,5,5,5,5,5
0,0,0,0,0,0,0,0,0,0,0,0,5,0,0,0,0,5,5,5,5
0,0,0,0,0,0,0,0,0,0,0,0,5,0,0,0,0,0,6,5,5
0,0,0,0,0,0,0,0,0,0,0,0,5,0,0,0,0,0,0,6,5
0,0,0,0,0,0,0,0,0,0,0,0,5,0,0,0,0,0,0,5,5
0,0,0,0,0,0,0,0,0,0,0,0,5,0,0,0,5,5,5,5,5
0,0,0,0,0,0,0,0,0,0,6,5,5,5,5,5,5,5,5,5,5
0,0,0,0,0,0,0,0,0,0,5,5,5,5,5,5,5,5,5,5,5

#Sprite Backgroud Layer
361,361,361,361,361,361,361,361,361,361,361,361,361,361,361,361,361,361,361,361,361
361,361,361,361,361,361,361,361,361,361,361,361,361,361,361,361,361,361,361,361,361
361,361,361,361,361,361,361,361,361,361,361,361,361,361,361,361,361,361,361,361,387
361,361,361,361,361,361,361,361,361,361,361,361,361,361,361,361,361,361,361,361,374
361,361,361,361,361,361,361,361,361,361,361,361,361,361,361,361,361,361,361,387,363
361,361,361,361,361,361,361,361,361,361,361,361,361,361,361,361,361,387,372,363,0
361,361,361,361,361,361,361,361,361,361,361,361,361,361,361,361,361,374,0,0,0
361,361,361,361,361,361,361,361,361,361,361,361,397,403,403,403,403,368,0,0,0
361,361,361,361,361,361,361,361,361,361,361,361,402,361,361,361,361,386,373,364,0
361,361,361,361,361,361,361,361,361,361,361,361,402,361,361,361,361,361,361,386,364
361,361,361,361,361,361,361,361,361,361,361,361,402,361,361,361,361,361,361,361,374
361,361,361,361,361,361,361,361,361,361,361,361,402,361,361,361,361,361,361,387,363
361,361,361,361,361,361,361,361,361,361,361,361,402,361,361,361,387,372,372,363,0
361,361,361,361,361,361,361,361,361,361,361,387,366,372,372,372,363,0,0,0,0
361,361,361,361,361,361,361,361,361,361,387,363,0,0,0,0,0,0,0,0,0

#Sprite Foregroud Layer
809,809,797,785,908,785,0,0,0,0,0,908,908,0,913,0,908,908,0,0,908
809,797,785,908,0,0,802,908,0,908,0,0,0,0,908,0,913,0,0,0,0
797,785,908,0,609,0,785,0,908,908,0,0,802,0,908,0,0,915,915,802,0
785,785,0,0,142,0,908,0,0,860,908,0,908,0,0,0,915,0,913,0,0
785,802,0,785,142,0,802,908,0,142,0,913,0,0,908,0,802,915,0,0,0
0,0,908,0,142,0,0,913,0,502,141,141,141,769,141,143,0,0,0,0,789
0,0,0,802,142,0,908,0,915,142,0,908,0,0,908,142,913,0,734,735,0
908,913,146,141,500,141,141,141,141,145,908,0,0,0,0,606,0,0,789,0,802
908,0,142,0,875,802,0,0,0,908,0,801,0,913,0,142,0,0,0,0,0
908,908,142,0,908,0,0,908,802,801,0,802,0,0,910,144,143,802,0,749,0
0,0,501,0,0,908,801,0,757,0,908,913,0,802,0,910,142,913,146,761,0
0,0,142,0,908,0,908,802,908,802,771,141,605,141,141,141,503,141,145,0,0
908,0,144,141,141,141,141,141,141,141,145,913,0,0,910,0,0,0,0,0,789
908,0,142,0,908,0,0,913,0,801,908,0,0,0,0,0,0,746,747,0,802
908,908,144,141,862,801,908,0,908,0,0,0,789,0,802,0,789,0,0,789,0

#Connections
0,0,0,0,0,0,0,0,0,0,0,0,0,0,0,0,0,0,0,0,0
0,0,0,0,0,0,0,0,0,0,0,0,0,0,0,0,0,0,0,0,0
0,0,0,0,1,0,0,0,0,0,0,0,0,0,0,0,0,0,0,0,0
0,0,0,0,1,0,0,0,0,1,0,0,0,0,0,0,0,0,0,0,0
0,0,0,0,1,0,0,0,0,1,0,0,0,0,0,0,0,0,0,0,0
0,0,0,0,1,0,0,0,0,9,2,2,2,2,2,6,0,0,0,0,0
0,0,0,0,1,0,0,0,0,1,0,0,0,0,0,1,0,0,0,0,0
0,0,5,2,8,2,2,2,2,3,0,0,0,0,0,14,0,0,0,0,0
0,0,1,0,0,0,0,0,0,0,0,0,0,0,0,1,0,0,0,0,0
0,0,1,0,0,0,0,0,0,0,0,0,0,0,0,4,6,0,0,0,0
0,0,1,0,0,0,0,0,0,0,0,0,0,0,0,0,1,0,5,2,0
0,0,1,0,0,0,0,0,0,0,5,2,13,2,2,2,8,2,3,0,0
0,0,9,2,2,2,2,2,2,2,3,0,0,0,0,0,0,0,0,0,0
0,0,1,0,0,0,0,0,0,0,0,0,0,0,0,0,0,0,0,0,0
0,0,4,2,2,0,0,0,0,0,0,0,0,0,0,0,0,0,0,0,0

#Tile Types
0,0,0,0,0,0,0,0,0,0,0,0,0,0,0,0,0,0,0,0,0
0,0,0,0,0,0,0,0,0,0,0,0,0,0,0,0,0,0,0,0,0
0,0,0,0,1,0,0,0,0,0,0,0,0,0,0,0,0,0,0,0,0
0,0,0,0,0,0,0,0,0,13,0,0,0,0,0,0,0,0,0,0,0
0,0,0,0,0,0,0,0,0,0,0,0,0,0,0,0,0,0,0,0,0
0,0,0,0,0,0,0,0,0,8,0,0,0,10,0,0,0,0,0,0,0
0,0,0,0,0,0,0,0,0,0,0,0,0,0,0,0,0,0,0,0,0
0,0,0,0,6,0,0,0,0,0,0,0,0,0,0,0,0,0,0,0,0
0,0,0,0,0,0,0,0,0,0,0,0,0,0,0,0,0,0,0,0,0
0,0,0,0,0,0,0,0,0,0,0,0,0,0,0,0,0,0,0,0,0
0,0,7,0,0,0,0,0,0,0,0,0,0,0,0,0,0,0,0,12,0
0,0,0,0,0,0,0,0,0,0,9,0,0,0,0,0,11,0,0,0,0
0,0,0,0,0,0,0,0,0,0,0,0,0,0,0,0,0,0,0,0,0
0,0,0,0,0,0,0,0,0,0,0,0,0,0,0,0,0,0,0,0,0
0,0,0,0,14,0,0,0,0,0,0,0,0,0,0,0,0,0,0,0,0

#Vehicle Boundaries
0,0,0,0,0,0,0,0,0,0,0,0,0,0,0,0,0,0,0,0,0
0,0,0,0,0,0,0,0,0,0,0,0,0,0,0,0,0,0,0,0,0
0,0,0,0,0,0,0,0,0,0,0,0,0,0,0,0,0,0,0,0,0
0,0,0,0,0,0,0,0,0,0,0,0,0,0,0,0,0,0,0,0,0
0,0,0,0,0,0,0,0,0,0,0,0,0,0,0,0,0,0,0,0,0
0,0,0,0,0,0,0,0,0,0,0,0,0,0,0,0,0,0,0,0,0
0,0,0,0,0,0,0,0,0,0,0,0,0,0,0,0,0,0,0,0,0
0,0,0,0,0,0,0,0,0,0,0,0,0,0,0,0,0,0,0,0,0
0,0,0,0,0,0,0,0,0,0,0,0,0,0,0,0,0,0,0,0,0
0,0,0,0,0,0,0,0,0,0,0,0,0,0,0,0,0,0,0,0,0
0,0,0,0,0,0,0,0,0,0,0,0,0,0,0,0,0,0,0,0,0
0,0,0,0,0,0,0,0,0,0,0,0,0,0,0,0,0,0,0,0,0
0,0,0,0,0,0,0,0,0,0,0,0,0,0,0,0,0,0,0,0,0
0,0,0,0,0,0,0,0,0,0,0,0,0,0,0,0,0,0,0,0,0
0,0,0,0,0,0,0,0,0,0,0,0,0,0,0,0,0,0,0,0,0

#Stages
#Stage Type 0,Map,Mode,Goal,Points,Bonus List(Max 10),Name,End World, then mode settings (see sample tour file for details)
#Stage Type 1,Bonus House Name,Sequential/Random Order,Display Text,Powerup List
9
0,Freaky home,0,10,1,0,Freaky Home,0,0
0,Ghost house,1,15,1,0,Ghost House,0,0,0
0,Ghosty,16,25,1,0,Ghosty,0,5,5,0,15,4,1
0,Haunted House,9,200,2,p16,Haunted House,0,1
0,House of Ancients,8,200,2,p116,House of Ancients,0,1,1
0,Flooded Ghosts,11,150,1,0,Flooded Ghosts,0,10,900,1,0,0
0,Ghostly Hall,2,120,3,0,Ghostly Hall,1,0,0,0
1,Toad's House,1,||Pick an item to help you on your way!||,p8,p11,p14
1,Poison House,1,||Choose an item if you dare!||,p0,p0,p3

#Warps
#location 1 x, y, location 2 x, y
0

#Vehicles
#Sprite,Stage Type, Start Column, Start Row, Min Moves, Max Moves, Sprite Paces, Sprite Direction, Boundary
0

#Initial Items
w1,w4,w9,w9,w14,w12,p18,p10,p7,p1
