#Version
1.8.0.0

#Music Category
0

#Width
20

#Height
15

#Sprite Water Layer
5,5,5,5,5,5,5,5,5,5,5,5,5,5,5,5,5,5,5,5
5,5,5,5,5,5,5,5,5,5,5,5,5,5,5,5,5,5,5,5
5,5,5,5,5,5,5,5,5,5,5,5,5,5,5,5,5,5,5,5
5,5,5,5,5,5,5,5,5,5,5,5,5,5,5,5,5,5,5,5
5,5,5,5,5,5,5,5,5,5,5,5,5,5,5,5,5,5,5,5
5,5,5,5,5,5,5,5,5,5,5,5,5,5,5,5,5,5,5,5
5,5,5,5,5,5,5,5,5,5,5,5,5,5,5,5,5,5,5,5
5,5,5,5,5,5,5,5,5,5,5,5,5,5,5,5,5,5,5,5
5,5,5,5,5,5,5,5,5,5,5,5,5,5,5,5,5,5,5,5
5,5,5,5,5,5,5,5,5,5,5,5,5,5,5,5,5,5,5,5
5,5,5,5,5,5,5,5,5,5,5,5,5,5,5,5,5,5,5,5
5,5,5,5,5,5,5,5,5,5,5,5,5,5,5,5,5,5,5,5
5,5,5,5,5,5,5,5,5,5,5,5,5,5,5,5,5,5,5,5
5,5,5,5,5,5,5,5,5,5,5,5,5,5,5,5,5,5,5,5
5,5,5,5,5,5,5,5,5,5,5,5,5,5,5,5,5,5,5,5

#Sprite Backgroud Layer
305,325,301,301,301,326,304,0,315,301,301,314,0,0,0,0,0,0,0,0
315,301,301,301,301,301,314,0,315,301,301,314,0,0,0,0,0,0,0,0
315,301,301,301,301,301,314,0,315,301,301,314,0,0,0,0,0,0,0,0
315,301,301,301,301,301,314,0,315,301,301,314,0,0,0,0,0,0,0,0
315,301,301,301,301,301,314,0,315,301,301,326,313,313,313,304,305,313,304,0
315,301,301,301,301,301,314,0,315,301,301,301,301,301,301,314,315,301,314,0
302,324,301,301,301,327,303,0,302,324,301,301,301,301,301,314,302,312,303,0
0,302,312,312,312,303,0,0,0,302,312,312,312,312,320,322,313,313,313,313
0,0,305,313,304,0,0,305,313,304,0,0,0,305,325,301,301,301,301,301
0,0,315,301,314,0,305,325,301,326,304,0,305,325,301,301,337,343,336,301
0,0,315,301,314,0,315,301,301,301,314,0,315,301,301,337,335,301,334,323
0,0,315,301,314,305,325,301,301,301,314,0,315,301,301,341,301,301,301,314
0,0,309,343,308,315,301,301,301,301,314,0,315,301,301,301,301,301,301,314
0,0,315,301,314,315,301,301,301,301,314,0,315,301,301,301,301,337,343,322
0,0,302,312,303,315,301,301,301,327,303,0,315,301,301,301,301,342,301,301

#Sprite Foregroud Layer
0,0,900,856,900,0,0,0,0,0,859,0,0,0,0,0,0,0,0,0
0,910,0,82,0,910,0,0,0,904,82,0,0,0,0,0,0,0,0,0
0,0,909,82,909,0,0,0,0,0,82,0,0,790,0,0,789,0,0,0
0,910,0,700,81,81,779,779,779,81,85,0,0,0,0,0,0,0,0,0
0,790,909,82,909,0,0,0,0,904,82,0,0,0,0,0,0,0,0,0
0,910,0,82,0,910,0,0,0,0,202,81,81,81,81,779,779,83,0,789
0,0,900,82,900,0,0,0,0,0,0,790,904,0,910,0,0,776,0,790
0,0,0,776,0,0,790,0,789,0,0,0,0,0,0,0,0,776,0,0
0,0,0,776,0,0,0,0,0,0,0,0,0,0,90,81,81,85,906,0
0,0,0,82,0,0,0,0,608,0,0,790,0,0,82,0,0,606,0,906
0,0,0,201,0,789,0,0,82,905,0,0,0,906,82,790,0,82,0,0
790,0,0,82,0,0,0,905,82,0,0,0,0,0,82,0,86,922,83,0
0,0,0,776,0,0,905,0,200,0,0,789,0,811,82,811,82,834,82,0
0,789,0,84,779,779,81,81,85,905,0,0,0,0,203,81,85,0,773,749
789,0,0,0,0,0,0,790,0,0,0,789,0,811,0,811,811,0,84,761

#Connections
0,0,0,1,0,0,0,0,0,0,1,0,0,0,0,0,0,0,0,0
0,0,0,1,0,0,0,0,0,0,1,0,0,0,0,0,0,0,0,0
0,0,0,1,0,0,0,0,0,0,1,0,0,0,0,0,0,0,0,0
0,0,0,9,2,2,2,2,2,2,7,0,0,0,0,0,0,0,0,0
0,0,0,1,0,0,0,0,0,0,1,0,0,0,0,0,0,0,0,0
0,0,0,1,0,0,0,0,0,0,4,2,2,2,2,2,2,6,0,0
0,0,0,1,0,0,0,0,0,0,0,0,0,0,0,0,0,1,0,0
0,0,0,1,0,0,0,0,0,0,0,0,0,0,0,0,0,1,0,0
0,0,0,1,0,0,0,0,0,0,0,0,0,0,5,2,2,7,0,0
0,0,0,1,0,0,0,0,1,0,0,0,0,0,1,0,0,14,0,0
0,0,0,1,0,0,0,0,1,0,0,0,0,0,1,0,0,1,0,0
0,0,0,1,0,0,0,0,1,0,0,0,0,0,1,0,5,8,6,0
0,0,0,1,0,0,0,0,1,0,0,0,0,0,1,0,1,0,1,0
0,0,0,4,2,2,2,2,3,0,0,0,0,0,4,2,3,0,1,0
0,0,0,0,0,0,0,0,0,0,0,0,0,0,0,0,0,0,4,2

#Tile Types
0,0,0,13,0,0,0,0,0,0,14,0,0,0,0,0,0,0,0,0
0,0,0,0,0,0,0,0,0,0,0,0,0,0,0,0,0,0,0,0
0,0,0,0,0,0,0,0,0,0,4,0,0,0,0,0,0,0,0,0
0,0,0,8,0,0,0,0,0,0,0,0,0,0,0,0,0,0,0,0
0,0,0,0,0,0,0,0,0,0,0,0,0,0,0,0,0,0,0,0
0,0,0,0,0,0,0,0,0,0,9,0,0,0,0,0,0,0,0,0
0,0,0,0,0,0,0,0,0,0,0,0,0,0,0,0,0,0,0,0
0,0,0,0,0,0,0,0,0,0,0,0,0,0,0,0,0,0,0,0
0,0,0,0,0,0,0,0,0,0,0,0,0,0,0,0,0,0,0,0
0,0,0,0,0,0,0,0,1,0,0,0,0,0,0,0,0,0,0,0
0,0,0,7,0,0,0,0,0,0,0,0,0,0,0,0,0,0,0,0
0,0,0,0,0,0,0,0,0,0,0,0,0,0,0,0,0,11,0,0
0,0,0,0,0,0,0,0,6,0,0,0,0,0,0,0,0,0,0,0
0,0,0,0,0,0,0,0,0,0,0,0,0,0,10,0,0,0,0,0
0,0,0,0,0,0,0,0,0,0,0,0,0,0,0,0,0,0,0,12

#Vehicle Boundaries
0,0,0,0,0,0,0,0,0,0,0,0,0,0,0,0,0,0,0,0
0,0,0,0,0,0,0,0,0,0,0,0,0,0,0,0,0,0,0,0
0,0,0,0,0,0,0,0,0,0,0,0,0,0,0,0,0,0,0,0
0,0,0,0,0,0,0,0,0,0,0,0,0,0,0,0,0,0,0,0
0,0,0,0,0,0,0,0,0,0,0,0,0,0,0,0,0,0,0,0
0,0,0,0,0,0,0,0,0,0,0,0,0,0,0,0,0,0,0,0
0,0,0,0,0,0,0,0,0,0,0,0,0,0,0,0,0,0,0,0
0,0,0,0,0,0,0,0,0,0,0,0,0,0,0,0,0,0,0,0
0,0,0,0,0,0,0,0,0,0,0,0,0,0,0,0,0,0,0,0
0,0,0,0,0,0,0,0,0,0,0,0,0,0,0,0,0,0,0,0
0,0,0,0,0,0,0,0,0,0,0,0,0,0,0,0,0,0,0,0
0,0,0,0,0,0,0,0,0,0,0,0,0,0,0,0,0,0,0,0
0,0,0,0,0,0,0,0,0,0,0,0,0,0,0,0,0,0,0,0
0,0,0,0,0,0,0,0,0,0,0,0,0,0,0,0,0,0,0,0
0,0,0,0,0,0,0,0,0,0,0,0,0,0,0,0,0,0,0,0

#Stages
#Stage Type 0,Map,Mode,Goal,Points,Bonus List(Max 10),Name,End World, then mode settings (see sample tour file for details)
#Stage Type 1,Bonus House Name,Sequential/Random Order,Display Text,Powerup List
9
0,Flip Room,4,50,1,0,Flip Room,0,0,8
0,Blox,15,15,1,0,Blox,0,1,0,0,10,0,0,0,0,7,7,8,10,9,7,8,0,7,0,0,0,0,5
0,Block Testing Grounds,1,15,2,1w7,Block Testing Grounds,0,0,0
0,Blocking Ground,13,15,1,0,Blocking Ground,0,9,9,2
0,Block Mayhem,9,100,1,0,Block Mayhem,0,1
0,Question block,0,20,2,1p1,Question Block,0,0
0,I guess Ill give it a Chance,2,100,3,0,Give it a Chance,1,0,0,10
1,Toad's House,1,||Pick an item to help you on your way!||,p2,p12,w13
1,Toad's House,1,||Pick an item to help you on your way!||,p3,p13,w14

#Warps
#location 1 x, y, location 2 x, y
0

#Vehicles
#Sprite,Stage Type, Start Column, Start Row, Min Moves, Max Moves, Sprite Paces, Sprite Direction, Boundary
0

#Initial Items
w1,w4,w13,w13,w9,w12,w11,p3,p2,p2,p1,p1,p1
