#Version
1.8.0.0

#Music Category
0

#Width
20

#Height
15

#Sprite Water Layer
0,0,0,0,0,0,0,0,0,0,0,0,0,0,0,0,0,0,0,0
0,0,0,0,0,0,0,0,0,0,0,0,0,0,0,0,0,0,0,0
0,0,0,0,0,0,0,0,0,0,0,0,0,0,0,0,0,0,0,0
0,0,0,0,0,0,0,0,0,0,0,0,0,6,6,6,0,0,0,0
0,0,0,0,0,0,0,0,0,0,0,0,0,6,0,6,6,0,0,0
0,0,0,0,0,0,0,0,0,0,0,0,0,6,6,6,0,0,0,0
0,0,0,0,0,0,0,0,0,0,0,0,0,0,0,0,0,0,0,0
0,0,0,0,0,0,0,0,0,0,0,0,0,0,0,0,0,0,0,0
0,0,0,0,0,0,0,0,0,0,0,0,0,0,0,0,0,0,0,0
0,0,0,0,0,0,0,0,0,0,0,0,0,0,0,0,0,0,0,0
0,0,0,0,0,0,0,0,0,0,0,0,0,0,0,0,0,0,0,0
0,0,0,0,0,0,0,0,0,0,0,0,0,0,0,0,0,0,0,0
0,0,0,0,0,0,0,0,0,0,0,0,0,0,0,0,0,0,0,0
0,0,0,0,0,0,0,0,0,0,0,0,0,0,0,0,0,0,0,0
0,0,0,0,0,0,0,0,0,0,0,0,0,0,0,0,0,0,0,0

#Sprite Backgroud Layer
27,12,12,3,0,0,0,0,0,0,0,0,0,0,0,0,0,0,255,241
3,5,13,13,13,4,0,5,13,13,13,7,13,13,13,13,13,4,242,252
0,15,1,1,1,26,13,25,1,1,1,42,28,1,1,1,1,26,4,0
0,15,1,1,1,1,1,1,28,1,1,42,1,37,43,36,1,1,14,0
0,15,1,1,1,1,1,1,1,1,1,42,1,42,1,31,38,1,14,0
0,15,1,1,1,1,1,1,1,1,1,42,1,34,43,35,1,1,14,0
0,15,1,1,1,1,1,1,1,1,1,42,1,1,1,1,1,27,3,0
0,15,1,1,1,1,1,1,1,1,1,42,1,1,1,39,23,3,29,0
0,15,1,1,1,40,1,40,1,1,1,42,1,1,1,1,26,4,0,0
0,15,1,1,1,42,1,42,1,1,1,42,1,1,40,1,1,26,4,0
0,15,1,1,1,19,12,16,1,1,1,42,1,1,19,24,1,1,14,0
0,15,1,1,1,14,0,15,1,1,1,42,1,1,14,15,1,1,14,0
0,15,1,1,1,14,29,15,1,1,1,42,1,1,14,15,1,1,14,0
0,2,12,12,12,3,0,2,12,12,12,6,12,12,3,2,12,12,3,5
13,4,0,0,0,0,0,0,0,0,0,0,0,0,0,0,0,5,13,25

#Sprite Foregroud Layer
0,0,0,0,0,0,0,801,0,0,0,0,0,0,0,0,0,0,0,911
0,0,0,0,0,0,0,0,0,0,0,0,0,0,0,0,0,0,801,0
0,0,0,901,784,0,0,0,901,901,0,0,0,0,913,800,0,0,0,0
0,0,784,608,0,0,784,0,0,856,0,0,913,802,733,0,913,0,0,0
0,0,784,2,784,0,757,0,901,2,901,0,0,0,745,802,0,800,0,0
0,0,902,2,902,0,2,0,784,2,0,0,844,0,777,0,800,913,0,0
0,0,784,300,1,1,5,1,1,301,0,0,2,913,2,913,0,0,0,0
0,0,902,2,0,901,0,0,901,2,901,0,4,1,305,0,0,0,0,0
0,0,0,2,901,0,909,0,0,2,901,0,2,0,788,788,0,0,0,0
0,0,0,302,1,605,1,605,1,303,0,0,4,788,0,788,0,0,0,0
0,0,784,2,0,0,0,0,0,2,785,0,2,910,0,0,910,910,0,0
0,0,0,844,784,0,0,0,785,2,785,0,304,1,13,15,1,857,0,0
0,0,784,0,784,0,0,0,0,706,1,772,5,910,0,0,910,910,0,0
0,0,0,0,0,0,0,0,0,0,0,0,0,0,0,0,0,0,0,0
0,0,0,0,0,0,0,0,0,0,0,0,0,0,801,0,0,0,0,0

#Connections
0,0,0,0,0,0,0,0,0,0,0,0,0,0,0,0,0,0,0,0
0,0,0,0,0,0,0,0,0,0,0,0,0,0,0,0,0,0,0,0
0,0,0,0,0,0,0,0,0,0,0,0,0,0,0,0,0,0,0,0
0,0,0,1,0,0,0,0,0,1,0,0,0,0,0,0,0,0,0,0
0,0,0,1,0,0,1,0,0,1,0,0,0,0,1,0,0,0,0,0
0,0,0,1,0,0,1,0,0,1,0,0,1,0,1,0,0,0,0,0
0,0,0,9,2,2,8,2,2,7,0,0,1,0,1,0,0,0,0,0
0,0,0,1,0,0,0,0,0,1,0,0,9,2,3,0,0,0,0,0
0,0,0,1,0,0,0,0,0,1,0,0,1,0,0,0,0,0,0,0
0,0,0,9,2,13,2,13,2,7,0,0,1,0,0,0,0,0,0,0
0,0,0,1,0,0,0,0,0,1,0,0,1,0,0,0,0,0,0,0
0,0,0,1,0,0,0,0,0,1,0,0,9,2,2,2,2,2,0,0
0,0,0,0,0,0,0,0,0,4,2,2,3,0,0,0,0,0,0,0
0,0,0,0,0,0,0,0,0,0,0,0,0,0,0,0,0,0,0,0
0,0,0,0,0,0,0,0,0,0,0,0,0,0,0,0,0,0,0,0

#Tile Types
0,0,0,0,0,0,0,0,0,0,0,0,0,0,0,0,0,0,0,0
0,0,0,0,0,0,0,0,0,0,0,0,0,0,0,0,0,0,0,0
0,0,0,0,0,0,0,0,0,0,0,0,0,0,0,0,0,0,0,0
0,0,0,1,0,0,0,0,0,16,0,0,0,0,0,0,0,0,0,0
0,0,0,0,0,0,12,0,0,0,0,0,0,0,14,0,0,0,0,0
0,0,0,0,0,0,0,0,0,0,0,0,0,0,0,0,0,0,0,0
0,0,0,6,0,0,0,0,0,7,0,0,3,0,0,0,0,0,0,0
0,0,0,0,0,0,0,0,0,0,0,0,0,0,11,0,0,0,0,0
0,0,0,0,0,0,0,0,0,0,0,0,0,0,0,0,0,0,0,0
0,0,0,8,0,0,0,0,0,9,0,0,0,0,0,0,0,0,0,0
0,0,0,0,0,0,0,0,0,0,0,0,0,0,0,0,0,0,0,0
0,0,0,0,0,0,0,0,0,0,0,0,10,0,0,0,0,16,0,0
0,0,0,0,0,0,0,0,0,13,0,0,0,0,0,0,0,0,0,0
0,0,0,0,0,0,0,0,0,0,0,0,0,0,0,0,0,0,0,0
0,0,0,0,0,0,0,0,0,0,0,0,0,0,0,0,0,0,0,0

#Vehicle Boundaries
0,0,0,0,0,0,0,0,0,0,0,0,0,0,0,0,0,0,0,0
0,0,0,0,0,0,0,0,0,0,0,0,0,0,0,0,0,0,0,0
0,0,0,0,0,0,0,0,0,0,0,0,0,0,0,0,0,0,0,0
0,0,0,0,0,0,0,0,0,0,0,0,0,0,0,0,0,0,0,0
0,0,0,0,0,0,0,0,0,0,0,0,0,0,0,0,0,0,0,0
0,0,0,0,0,0,0,0,0,1,0,0,0,0,0,0,0,0,0,0
0,0,0,0,0,0,0,0,1,0,0,0,0,0,0,0,0,0,0,0
0,0,0,0,0,0,0,0,0,0,0,0,0,0,0,0,0,0,0,0
0,0,0,0,0,0,0,0,0,0,0,0,0,0,0,0,0,0,0,0
0,0,0,0,0,0,0,0,1,0,0,0,0,0,0,0,0,0,0,0
0,0,0,0,0,0,0,0,0,0,0,0,0,0,0,0,0,0,0,0
0,0,0,0,0,0,0,0,0,0,0,0,0,0,0,0,0,0,0,0
0,0,0,0,0,0,0,0,0,0,1,0,0,0,0,0,0,0,0,0
0,0,0,0,0,0,0,0,0,0,0,0,0,0,0,0,0,0,0,0
0,0,0,0,0,0,0,0,0,0,0,0,0,0,0,0,0,0,0,0

#Stages
#Stage Type 0,Map,Mode,Goal,Points,Bonus List(Max 10),Name,End World, then mode settings (see sample tour file for details)
#Stage Type 1,Bonus House Name,Sequential/Random Order,Display Text,Powerup List
11
0,MrIsland1,0,5,10,0,Stage 1,0,0
0,MrIsland2,0,5,10,0,Stage 2,0,0
0,MrIsland3,0,5,10,0,Stage 3,0,0
0,MrIsland4,0,5,10,0,Stage 4,0,0
0,MrIsland5,0,5,10,0,Stage 5,0,0
0,MrIsland6,0,5,10,0,Stage 6,0,0
0,MrIslandGhost,20,30,5,1w6,Ghost House,0,5,3,2,1
0,MrIslandFort,16,5,20,1w13,Fortress,0,9,4,1,30,3,1
0,MrIslandCastle,0,10,30,0,Castle,1,0
0,MrIslandBattle,0,2,0,1p2,Battle!,0,0
1,Toad's House,1,|Pick a Powerup To|Help You On Your Way,p1,p5,p11

#Warps
#location 1 x, y, location 2 x, y
1
3,11,12,5

#Vehicles
#Sprite,Stage Type, Start Column, Start Row, Min Moves, Max Moves, Sprite Paces, Sprite Direction, Boundary
1
1,9,9,9,1,2,0,0,1

#Initial Items
p7,w4,w9
