#Version
1.8.0.0

#Music Category
0

#Width
14

#Height
9

#Sprite Water Layer
0,0,0,0,0,0,0,0,0,0,0,0,0,0
0,0,0,0,0,0,0,0,0,0,0,0,0,0
0,0,0,0,0,0,0,0,0,0,0,0,0,0
0,0,0,0,0,0,0,0,0,0,0,0,0,0
0,0,0,0,0,0,0,0,0,0,0,0,0,0
0,0,0,0,0,0,0,0,0,0,0,0,0,0
0,0,0,0,0,0,0,0,0,0,0,0,0,0
0,0,0,0,0,0,0,0,0,0,0,0,0,0
0,0,0,0,0,0,0,0,0,0,0,0,0,0

#Sprite Backgroud Layer
1,1,1,1,1,1,1,1,1,1,1,1,1,1
1,1,1,1,1,1,1,1,1,1,1,1,1,1
1,1,1,1,1,1,1,1,1,1,1,1,1,1
1,1,1,1,1,1,1,1,1,1,1,1,1,1
1,1,1,1,1,1,1,1,1,1,37,43,36,1
1,1,1,1,1,1,1,1,37,43,35,1,42,1
1,1,1,1,1,1,1,1,42,1,1,1,42,1
1,1,1,1,1,1,1,1,42,1,1,1,42,1
1,1,1,1,1,1,1,1,34,43,43,43,35,1

#Sprite Foregroud Layer
901,901,901,300,1,3,1,301,1,302,1,3,901,901
901,901,901,2,901,901,901,2,901,901,901,2,901,901
1,608,1,5,901,901,901,4,1,303,1,857,901,901
901,901,901,2,901,901,901,2,901,901,901,901,901,901
901,901,901,4,1,700,1,923,901,901,0,0,0,901
901,0,0,2,0,0,0,0,0,0,0,749,0,901
0,0,784,4,784,857,1,3,772,3,1,761,0,901
0,784,784,2,784,784,0,2,0,0,0,0,0,901
0,784,784,304,1,3,1,305,0,0,0,0,0,901

#Connections
0,0,0,5,2,2,2,10,2,2,2,6,0,0
0,0,0,1,0,0,0,1,0,0,0,1,0,0
0,2,2,7,0,0,0,9,2,2,2,3,0,0
0,0,0,1,0,0,0,1,0,0,0,0,0,0
0,0,0,9,2,2,2,3,0,0,0,0,0,0
0,0,0,1,0,0,0,0,0,0,0,0,0,0
0,0,0,1,0,2,2,10,2,2,2,2,0,0
0,0,0,1,0,0,0,1,0,0,0,0,0,0
0,0,0,4,2,2,2,3,0,0,0,0,0,0

#Tile Types
0,0,0,7,0,0,0,8,0,9,0,0,0,0
0,0,0,0,0,0,0,0,0,0,0,0,0,0
0,1,0,0,0,0,0,0,0,10,0,15,0,0
0,0,0,3,0,0,0,0,0,0,0,0,0,0
0,0,0,0,0,13,0,17,0,0,0,0,0,0
0,0,0,0,0,0,0,0,0,0,0,0,0,0
0,0,0,0,0,16,0,0,0,0,0,14,0,0
0,0,0,0,0,0,0,0,0,0,0,0,0,0
0,0,0,11,0,0,0,12,0,0,0,0,0,0

#Vehicle Boundaries
0,0,0,0,0,0,0,0,0,0,0,0,0,0
0,0,0,0,0,0,0,0,0,0,0,0,0,0
0,0,0,0,0,0,0,0,0,0,0,0,0,0
0,0,0,1,0,0,0,0,0,0,0,0,0,0
0,0,0,0,1,0,0,0,0,0,0,0,0,0
0,0,0,0,0,0,0,0,0,0,0,0,0,0
0,0,0,0,0,0,0,0,0,0,1,0,0,0
0,0,0,0,0,0,0,0,0,0,0,0,0,0
0,0,0,0,0,0,0,0,0,0,0,0,0,0

#Stages
#Stage Type 0,Map,Mode,Goal,Points,Bonus List(Max 10),Name,End World, then mode settings (see sample tour file for details)
#Stage Type 1,Bonus House Name,Sequential/Random Order,Display Text,Powerup List
12
0,Wood Pit,15,20,2,1p6,Hammer Bros,0,5,0,0,1,1,1,1,1,1,1,1,1,1,1,1,1,1,1,1,1,1,0
0,Grassland 1,5,10,1,1p1,Level 1,0,120,1,1,0,1
0,Grassland 2,4,10,1,1p9,Level 2,0,1,5
0,Grassland 3,5,10,1,1w6,Level 3,0,120,1,1,0,1
0,Grassland 4,0,10,1,1w11,Level 4,0
0,Grassland 5,13,3,1,1w1,Level 5,0,4,4,1
0,Grassland 6,5,10,1,1p25,Level 6,0,120,1,1,0,1
0,Grassland fortress,16,5,1,1p7,fortress,0,1,1,1,40,2,1
0,Grassland airship,15,30,2,0,Doomship,1,5,0,0,1,1,1,1,1,1,1,1,1,1,1,1,1,1,1,1,1,1,0
1,Toad House,1,||Pick a box.,p1,p5,p17
1,Toad House,1,||Pick a box.,p1,p5,p17
1,Spade House,1,||Pick a box.,p1,p5,p17

#Warps
#location 1 x, y, location 2 x, y
0

#Vehicles
#Sprite,Stage Type, Start Column, Start Row, Min Moves, Max Moves, Sprite Paces, Sprite Direction, Boundary
1
0,0,3,8,2,8,1,0,0

#Initial Items
p1